1111111111111
10000000000C1
1000011111001
100E110P00000
1111111111111
