111111111111111111111
1X1000X000000000000C1
1000000000C0000000X01
100010000000000C00X01
100001111100110001001
100011E00000001100001
1P0011000000001C00001
111111111111111111111
