11111111111111111
1000000000C0000C1
10C00111110011111
100E1100P0001
1111111111111
