1111111111111
1000000000011
1000011111001
100E1100P0001
1111111111111
