1111111111111
101000X0000C1
1P00100000001
1000011111001
100011E000001
1111111111111
